00000000000000000000
00000000000000000000
00000000000000000000
00000000000000000000
00000000000000113330
02220111111111103330
02220111111111103330
02220111111111103330
02220111111111103330
02221100000000000000
00000000000000000000
00000000000000000000
00000000000000000000
00000000000000000000
00000000000000000000

Format: x-y-x1,y1-x2,y2-speed-move_left_first
IMPORTANT: x2 > x1

14 - 5 - 5,5 - 13,5 - 2.25 - true
14 - 7 - 5,7 - 13,7 - 2.25 - true
5 - 6 - 5,6 - 13,6 - 2.25 - false
5 - 8 - 5,8 - 13,8 - 2.25 - false